activity	활동
autumn	가을
bird	새
clothes	옷
clean	깨끗한
course	과정
different	다른
earth	지구
each	각각
example	예
enjoy	즐기다
fire	불
face	얼굴
fun	재미
hand	손
important	중요한
job	직업
life	인생
letter	편지
learn	배우다
lot	많이
listen	듣다
light	빛
make	만들다
movie	영화
mind	마음
name	이름
newspaper	신문
problem	문제
place	장소
person	사람
part	부분
paper	종이
plant	식물
story	이야기
same	같은
spring	봄
space	공간
start	시작
summer	여름
street	거리
trip	여행
vacation	휴가
volunteer	자원봉사자
visit	방문
work	일
winter	겨울
watch	시계
win	이기다
